"order","family","genus","n","n_dio","diff."
"Alismatales","Alismataceae","Burnatia",1,1,0
"Alismatales","Alismataceae","Sagittaria",20,1,19
"Alismatales","Aponogetonaceae","Aponogeton",44,1,43
"Alismatales","Cymodoceaceae","Amphibolis",2,2,0
"Alismatales","Cymodoceaceae","Cymodocea",4,4,0
"Alismatales","Cymodoceaceae","Halodule",6,6,0
"Alismatales","Cymodoceaceae","Syringodium",2,2,0
"Alismatales","Cymodoceaceae","Thalassodendron",2,2,0
"Alismatales","Hydrocharitaceae","Appertiella",1,1,0
"Alismatales","Hydrocharitaceae","Blyxa",12,2,10
"Alismatales","Hydrocharitaceae","Elodea",12,12,0
"Alismatales","Hydrocharitaceae","Ottelia",30,30,0
"Alismatales","Hydrocharitaceae","Lagarosiphon",9,9,0
"Alismatales","Hydrocharitaceae","Stratiotes",1,1,0
"Alismatales","Hydrocharitaceae","Hydrocharis",2,2,0
"Alismatales","Hydrocharitaceae","Hydromystria",1,1,0
"Alismatales","Hydrocharitaceae","Maidenia",1,1,0
"Alismatales","Hydrocharitaceae","Najas",35,1,34
"Alismatales","Hydrocharitaceae","Thalassia",2,2,0
"Alismatales","Hydrocharitaceae","Enhalus",1,1,0
"Alismatales","Hydrocharitaceae","Halophila",9,5,4
"Alismatales","Hydrocharitaceae","Nechamandra",1,1,0
"Alismatales","Hydrocharitaceae","Hydrilla",1,1,0
"Alismatales","Hydrocharitaceae","Vallisneria",5,5,0
"Alismatales","Juncaginaceae","Tetroncium",1,1,0
"Alismatales","Potamogetonaceae","Lepilaena",4,4,0
"Alismatales","Zosteraceae","Phyllospadix",5,3,2
"Apiales","Apiaceae","Aciphylla",39,16,23
"Apiales","Apiaceae","Anisotome",13,13,0
"Apiales","Apiaceae","Arctopus",3,3,0
"Apiales","Apiaceae","Ledebouriella",2,2,0
"Apiales","Apiaceae","Mulinum",20,1,19
"Apiales","Apiaceae","Trinia",11,11,0
"Apiales","Araliaceae","Aralia",36,20,16
"Apiales","Araliaceae","Dendropanax",30,10,20
"Apiales","Araliaceae","Meryta",25,25,0
"Apiales","Araliaceae","Oreopanax",80,10,70
"Apiales","Araliaceae","Polyscias",24,14,10
"Apiales","Griseliniaceae","Griselinia",7,7,0
"Apiales","Pittosporaceae","Pittosporum",200,1,199
"Apiales","Torricelliaceae","Aralidium",1,1,0
"Apiales","Torricelliaceae","Toricellia",2,2,0
"Apiales","Pennantiaceae","Pennantia",3,3,0
"Aquifoliales","Aquifoliaceae","Ilex",405,300,105
"Aquifoliales","Helwingiaceae","Helwingia",3,3,0
"Arecales","Arecaceae","Aphandra",1,1,0
"Arecales","Arecaceae","Pseudophoenix",4,1,3
"Arecales","Arecaceae","Ravenea",9,9,0
"Arecales","Arecaceae","Phytelephas",12,12,0
"Arecales","Arecaceae","Ceroxylon",15,15,0
"Arecales","Arecaceae","Juania",1,1,0
"Arecales","Arecaceae","Borassus",7,7,0
"Arecales","Arecaceae","Lodoicea",1,1,0
"Arecales","Arecaceae","Latania",3,3,0
"Arecales","Arecaceae","Medemia",1,1,0
"Arecales","Arecaceae","Hyphaene",9,9,0
"Arecales","Arecaceae","Calamus",370,370,0
"Arecales","Arecaceae","Calospatha",1,1,0
"Arecales","Arecaceae","Ceratolobus",6,6,0
"Arecales","Arecaceae","Daemonorops",114,114,0
"Arecales","Arecaceae","Plectocomia",16,16,0
"Arecales","Arecaceae","Plectocomiopsis",5,5,0
"Arecales","Arecaceae","Mauritia",2,2,0
"Arecales","Arecaceae","Lepidocaryum",9,9,0
"Arecales","Arecaceae","Korthalsia",26,26,0
"Arecales","Arecaceae","Chamaedorea",110,110,0
"Arecales","Arecaceae","Chamaerops",1,1,0
"Arecales","Arecaceae","Drymophloeus",15,2,13
"Arecales","Arecaceae","Orbignya",20,1,19
"Arecales","Arecaceae","Phoenix",17,17,0
"Arecales","Arecaceae","Pholidocarpus",5,5,0
"Arecales","Arecaceae","Rhapidophyllum",1,1,0
"Arecales","Arecaceae","Rhapis",12,10,2
"Arecales","Arecaceae","Salacca",15,15,0
"Arecales","Arecaceae","Trachycarpus",4,4,0
"Arecales","Arecaceae","Wendlandiella",3,3,0
"Asparagales","Asparagaceae","Asparagus",50,1,49
"Asparagales","Asteliaceae","Astelia",25,25,0
"Asparagales","Asteliaceae","Collospermum",5,5,0
"Asparagales","Laxmanniaceae","Lomandra",35,35,0
"Asparagales","Nolinaceae",,49,49,0
"Asparagales","Nolinaceae","Beaucarnea",10,10,0
"Asparagales","Nolinaceae","Calibanus",1,1,0
"Asparagales","Nolinaceae","Dasylirion",15,15,0
"Asparagales","Nolinaceae","Nolina",23,23,0
"Asparagales","Ruscaceae","Ruscus",6,6,0
"Asterales","Asteraceae","Anaphalis",,,
"Asterales","Asteraceae","Anaphaloides",,,
"asterales","Asteraceae","Antennaria",45,15,30
"Asterales","Asteraceae","Ewartia",,,
"asterales","Asteraceae","Baccharis",350,350,0
"asterales","Asteraceae","Blumea",75,30,45
"asterales","Asteraceae","Brachylaena",23,23,0
"asterales","Asteraceae","Tarchonanthus",4,2,2
"Asterales","Asteraceae","Cratystylis",4,4,0
"asterales","Asteraceae","Carduus",91,10,81
"asterales","Asteraceae","Chaetanthera",41,2,39
"asterales","Asteraceae","Cirsium",200,2,198
"asterales","Asteraceae","Cotula",80,1,79
"asterales","Asteraceae","Doniophyton",2,1,1
"asterales","Asteraceae","Epaltes",15,10,5
"asterales","Asteraceae","Gochnatia",10,10,0
"asterales","Asteraceae","Heterothalamus",8,1,7
"asterales","Asteraceae","Lycoseris",66,10,56
"asterales","Asteraceae","Mikania",400,1,399
"asterales","Asteraceae","Mniodes",5,2,3
"asterales","Asteraceae","Monactis",8,1,7
"asterales","Asteraceae","Moquinia",1,1,0
"asterales","Asteraceae","Myripnois",3,3,0
"asterales","Asteraceae","Parastrephia",5,1,4
"asterales","Asteraceae","Petasites",15,15,0
"asterales","Asteraceae","Petrobium",1,1,0
"asterales","Asteraceae","Pluchea",40,30,10
"asterales","Asteraceae","Podanthus",2,2,0
"asterales","Asteraceae","Pterocaulon",18,11,7
"asterales","Asteraceae","Robinsonia",6,6,0
"asterales","Asteraceae","Senecio",1500,10,1490
"asterales","Asteraceae","Vernonia",1000,1,999
"asterales","Campanulaceae","Lobelia",365,4,361
"asterales","Menyanthaceae","Nymphoides",20,2,18
"asterales","Phellinaceae","Phelline",12,12,0
"Brassicales","Bataceae","Batis",2,2,0
"Brassicales","Brassicaceae","Apophyllum",1,1,0
"Brassicales","Brassicaceae","Forchhammeria",10,2,8
"Brassicales","Caricaceae","Vasconcellea",20,18,2
"Brassicales","Caricaceae","Horovitzia",1,1,0
"Brassicales","Caricaceae","Carica",1,0,1
"Brassicales","Caricaceae","Cylicomorpha",2,2,0
"Brassicales","Caricaceae","Jacaratia",8,7,1
"Brassicales","Caricaceae","Jarilla",3,3,0
"Brassicales","Gyrostemonaceae","Codonocarpus",2,1,1
"Brassicales","Gyrostemonaceae","Gyrostemon",6,6,0
"Brassicales","Gyrostemonaceae","Tersonia",1,1,0
"Brassicales","Salvadoraceae","Azima",4,2,2
"caryophyllales","Achatocarpaceae","Achatocarpus",5,5,0
"caryophyllales","Achatocarpaceae","Phaulothamnus",1,1,0
"caryophyllales","Amaranthaceae","Aerva",10,1,9
"caryophyllales","Amaranthaceae","Amaranthus",60,45,15
"caryophyllales","Amaranthaceae","Atriplex",300,50,250
"caryophyllales","Amaranthaceae","Chamissoa",2,1,1
"caryophyllales","Amaranthaceae","Deeringia",11,1,10
"caryophyllales","Amaranthaceae","Endolepis",3,2,1
"caryophyllales","Amaranthaceae","Grayia",2,2,0
"caryophyllales","Amaranthaceae","Zuckia",1,1,0
"caryophyllales","Amaranthaceae","Iresine",80,30,50
"caryophyllales","Amaranthaceae","Roycea",2,2,0
"caryophyllales","Sarcobataceae","Sarcobatus",1,1,0
"caryophyllales","Amaranthaceae","Spinacia",3,3,0
"caryophyllales","Cactaceae","Echinocereus",47,1,46
"caryophyllales","Cactaceae","Opuntia",300,3,297
"caryophyllales","Caryophyllaceae","Honkenya",1,1,0
"caryophyllales","Caryophyllaceae","Paronychia",6,1,5
"caryophyllales","Caryophyllaceae","Philippiella",1,1,0
"caryophyllales","Caryophyllaceae","Schiedea",18,3,15
"caryophyllales","Caryophyllaceae","Silene",600,10,590
"caryophyllales","Didiereaceae",,10,10,0
"caryophyllales","Didiereaceae","Alluaudia",6,6,0
"caryophyllales","Didiereaceae","Alluaudiopsis",2,2,0
"caryophyllales","Didiereaceae","Didierea",2,2,0
"caryophyllales","Molluginaceae","Glischrothamus",1,1,0
"caryophyllales","Nepenthaceae","Nepenthes",90,90,0
"caryophyllales","Nyctaginaceae","Guapira",3,3,0
"caryophyllales","Nyctaginaceae","Neea",80,20,60
"caryophyllales","Nyctaginaceae","Pisonia",35,20,15
"caryophyllales","Physenaceae","Physena",2,2,0
"caryophyllales","Phytolaccaceae","Ledenbergia",2,1,1
"caryophyllales","Phytolaccaceae","Monococcus",1,1,0
"caryophyllales","Phytolaccaceae","Phytolacca",25,5,20
"caryophyllales","Polygonaceae","Coccoloba",120,2,118
"caryophyllales","Polygonaceae","Fallopia",18,1,17
"caryophyllales","Polygonaceae","Harfordia",1,1,0
"caryophyllales","Polygonaceae","Muehlenbeckia",23,23,0
"caryophyllales","Polygonaceae","Polygonella",5,1,4
"caryophyllales","Polygonaceae","Rumex",200,2,198
"caryophyllales","Polygonaceae","Ruprechtia+Triplaris",55,55,0
"caryophyllales","Polygonaceae","Ruprechtia",20,20,0
"caryophyllales","Polygonaceae","Triplaris",18,18,0
"caryophyllales","Polygonaceae","Symmeria",1,1,0
"caryophyllales","Simmondsiaceae","Simmondsia",1,1,0
"Celastrales","Celastraceae","Cassine+Maurocenia",41,41,0
"Celastrales","Celastraceae","Cassine",40,40,0
"Celastrales","Celastraceae","Maurocenia",1,1,0
"Celastrales","Celastraceae","Maytenus",225,50,175
"Celastrales","Celastraceae","Empleuridium",1,1,0
"Celastrales","Celastraceae","Microtropis",70,70,0
"Celastrales","Celastraceae","Otherodendron",8,7,1
"Celastrales","Celastraceae","Schaefferia",16,2,14
"Celastrales","Celastraceae","Tetrasiphon",1,1,0
"Celastrales","Lepidobotryaceae","Lepidobotrys",1,1,0
"Celastrales","Lepidobotryaceae","Ruptilicarpon",1,1,0
"Commelinales","Hanguanaceae","Hanguana",10,10,0
"Cornales","Cornaceae","Cornus",45,1,44
"Cornales","Cornaceae","Nyssa",5,5,0
"Cornales","Hydrostachyaceae","Hydrostachys",22,22,0
"cucurbitales","Begoniaceae","Begonia",900,50,850
"cucurbitales","Cucurbitaceae","Abobra",1,1,0
"cucurbitales","Cucurbitaceae","Acanthosicyos",2,1,1
"cucurbitales","Cucurbitaceae","Ampelosycios",3,3,0
"cucurbitales","Cucurbitaceae","Telfairia",3,3,0
"cucurbitales","Cucurbitaceae","Cogniauxia",1,1,0
"cucurbitales","Cucurbitaceae","Schizopepon",8,6,2
"cucurbitales","Cucurbitaceae","Biswarea",1,1,0
"cucurbitales","Cucurbitaceae","Herpetospermum",1,1,0
"cucurbitales","Cucurbitaceae","Edgaria",1,1,0
"cucurbitales","Cucurbitaceae","Bryonia",10,8,2
"cucurbitales","Cucurbitaceae","Calycophysum",5,2,3
"cucurbitales","Cucurbitaceae","Cayaponia",45,1,44
"cucurbitales","Cucurbitaceae","Coccinia",30,20,10
"cucurbitales","Cucurbitaceae","Cucumis",30,1,29
"cucurbitales","Cucurbitaceae","Doyerea",2,2,0
"cucurbitales","Cucurbitaceae","Helmontia",1,1,0
"cucurbitales","Cucurbitaceae","Wilbrandia",2,1,1
"cucurbitales","Cucurbitaceae","Apodanthera",14,7,7
"cucurbitales","Cucurbitaceae","Kedrostis",23,12,11
"cucurbitales","Cucurbitaceae","Trochomeriopsis",1,1,0
"cucurbitales","Cucurbitaceae","Ibervillea",3,3,0
"cucurbitales","Cucurbitaceae","Ecballium",1,1,0
"cucurbitales","Cucurbitaceae","Eureiandra",10,1,9
"cucurbitales","Cucurbitaceae","Fevillea",7,7,0
"cucurbitales","Cucurbitaceae","Sicydium",6,6,0
"cucurbitales","Cucurbitaceae","Gerrardanthus",5,1,4
"cucurbitales","Cucurbitaceae","Gynostemma",2,2,0
"cucurbitales","Cucurbitaceae","Hemsleya",30,30,0
"cucurbitales","Cucurbitaceae","Siolmatra",3,3,0
"cucurbitales","Cucurbitaceae","Zanonia",1,1,0
"cucurbitales","Cucurbitaceae","Gymnopetalum",3,3,0
"cucurbitales","Cucurbitaceae","Hodgsonia",2,2,0
"cucurbitales","Cucurbitaceae","Lagenaria",6,6,0
"cucurbitales","Cucurbitaceae","Luffa",6,1,5
"cucurbitales","Cucurbitaceae","Melothria",10,1,9
"cucurbitales","Cucurbitaceae","Momordica",47,24,23
"cucurbitales","Cucurbitaceae","Thladiantha",23,23,0
"cucurbitales","Cucurbitaceae","Trichosanthes",15,1,14
"cucurbitales","Cucurbitaceae","Trochomeria",7,7,0
"cucurbitales","Cucurbitaceae","Zehneria",30,30,0
"cucurbitales","Datiscaceae","Datisca",2,1,1
"cucurbitales","Tetramelaceae","Octomeles",1,1,0
"cucurbitales","Tetramelaceae","Tetrameles",1,1,0
"Dioscoreales","Dioscoreaceae","Borderea",2,1,1
"Dioscoreales","Dioscoreaceae","Dioscorea",450,450,0
"Dioscoreales","Dioscoreaceae","Rajania",20,20,0
"Dioscoreales","Dioscoreaceae","Tamus",4,4,0
"dipsacales","Valerianaceae","Phuodendron",1,1,0
"dipsacales","Valerianaceae","Valeriana",250,10,240
"ericales","Actinidiaceae","Actinidia",30,8,22
"ericales","Actinidiaceae","Saurauia",300,10,290
"ericales","Ebenaceae","Diospyros",475,475,0
"ericales","Ebenaceae","Euclea",12,12,0
"ericales","Ericaceae","Ceratiola",1,1,0
"ericales","Ericaceae","Corema",2,2,0
"ericales","Ericaceae","Empetrum",2,2,0
"ericales","Ericaceae","Cyathodes",12,8,4
"ericales","Ericaceae","Epigaea",3,1,2
"ericales","Ericaceae","Gaultheria s.l.",150,4,146
"ericales","Ericaceae","Pernettya",20,1,19
"ericales","Myrsinaceae","Amblyanthus",4,1,3
"ericales","Myrsinaceae","Cybianthus",124,1,123
"ericales","Myrsinaceae","Discocalyx",50,20,30
"ericales","Myrsinaceae","Embelia",130,92,38
"ericales","Myrsinaceae","Geissanthus",35,20,15
"ericales","Myrsinaceae","Grenacheria",10,10,0
"ericales","Myrsinaceae","Maesa",100,50,50
"ericales","Myrsinaceae","Monoporus",8,8,0
"ericales","Myrsinaceae","Myrsine",5,1,4
"ericales","Myrsinaceae","Rapanea",150,50,100
"ericales","Myrsinaceae","Stylogyne",60,60,0
"ericales","Sapotaceae","Chrysophyllum",80,10,70
"ericales","Sapotaceae","Pouteria",50,20,30
"ericales","Sapotaceae","Sideroxylon sl",100,1,99
"ericales","Styracaceae","Bruinsmia",2,2,0
"ericales","Symplocaceae","Symplocos",250,1,249
"ericales","Pentaphylacaceae","Eurya",70,70,0
"ericales","Pentaphylacaceae","Ternstroemia",85,24,61
"ericales","Theophrastaceae","Clavija",50,33,17
"euasterids 1","Boraginaceae","Cordia",250,1,249
"euasterids 1","Boraginaceae","Lepidocordia",2,2,0
"euasterids 1","Boraginaceae","Rochefortia",3,3,0
"Rosid (unplaced)","Icacinaceae","Chlamydocarya",6,3,3
"Rosid (unplaced)","Icacinaceae","Gonocaryum",9,1,8
"Rosid (unplaced)","Icacinaceae","Grisollea",2,2,0
"Rosid (unplaced)","Icacinaceae","Miquelia",8,5,3
"Rosid (unplaced)","Icacinaceae","Natsiatopsis",1,1,0
"Rosid (unplaced)","Icacinaceae","Natsiatum",1,1,0
"Rosid (unplaced)","Icacinaceae","Phytocrene",11,11,0
"Rosid (unplaced)","Icacinaceae","Polycephalium",2,1,1
"Rosid (unplaced)","Icacinaceae","Polyporandra",1,1,0
"Rosid (unplaced)","Icacinaceae","Pyrenacantha",20,6,14
"Rosid (unplaced)","Icacinaceae","Rhaphiostylis",6,1,5
"Rosid (unplaced)","Icacinaceae","Sarcostigma",2,2,0
"Rosid (unplaced)","Icacinaceae","Stachyanthus",6,1,5
"Berberopsidales","Aextoxicaceae","Aextoxicon",1,1,0
"Buxales","Didymelaceae","Didymeles",2,2,0
"Dilleniales","Dilleniaceae","Tetracera",40,15,25
"Gunnerales","Myrothamnaceae","Myrothamnus",2,2,0
"eudicots","Vitaceae","Tetrastigma",95,95,0
"eudicots","Vitaceae","Vitis",65,28,37
"Picramniales","Picramniaceae","Alvaradoa",5,2,3
"Picramniales","Picramniaceae","Picramnia",40,30,10
"Fabales","Fabaceae","Ateleia",21,21,0
"Fabales","Fabaceae","Bauhinia",100,10,90
"Fabales","Fabaceae","Ceratonia",2,1,1
"Fabales","Fabaceae","Gymnocladus",5,2,3
"Fabales","Fabaceae","Myroxylon",2,2,0
"Fabales","Fabaceae","Pentaclethra",2,1,1
"Fabales","Quillajaceae","Quillaja",4,1,3
"Fagales","Casuarinaceae","Allocasuarina",59,30,29
"Fagales","Casuarinaceae","Casuarina",17,10,7
"Fagales","Casuarinaceae","Ceuthostoma",2,2,0
"Fagales","Casuarinaceae","Gymnostoma",18,9,9
"Fagales","Myricaceae","Canacomyrica",1,1,0
"Fagales","Myricaceae","Comptonia",1,1,0
"Fagales","Myricaceae","Myrica",50,40,10
"Fagales","Ticodendraceae","Ticodendron",1,1,0
"Garryales","Garryaceae","Aucuba",4,4,0
"Garryales","Garryaceae","Garrya",13,13,0
"Gentianales","Loganiaceae","Labordia",17,17,0
"Gentianales","Rubiaceae","Metabolos",4,"?","#VALUE!"
"Gentianales","Rubiaceae","Amaioua",25,25,0
"Gentianales","Rubiaceae","Duroia",20,20,0
"Gentianales","Rubiaceae","Kutchubea",11,11,0
"Gentianales","Rubiaceae","Randia",100,10,90
"Gentianales","Rubiaceae","Alibertia",35,20,15
"Gentianales","Rubiaceae","Genipa",7,1,6
"Gentianales","Rubiaceae","Stachyarrhena",10,1,9
"Gentianales","Rubiaceae","Anthospermeae",170,142,28
"Gentianales","Rubiaceae","Anthospermum",40,40,0
"Gentianales","Rubiaceae","Nenax",9,9,0
"Gentianales","Rubiaceae","Carpacoce",7,7,0
"Gentianales","Rubiaceae","Coprosma",90,80,10
"Gentianales","Rubiaceae","Opercularia",15,5,10
"Gentianales","Rubiaceae","Phyllis",2,0,2
"Gentianales","Rubiaceae","Normandia",1,0,1
"Gentianales","Rubiaceae"," Anthospermeae","Nertera",6,1
"Gentianales","Rubiaceae","Antirhea",40,20,20
"Gentianales","Rubiaceae"," Rubieae","Asperula",194,16
"Gentianales","Rubiaceae","Bathysa",10,3,7
"Gentianales","Rubiaceae","Byrsophyllum",2,2,0
"Gentianales","Rubiaceae","Cinchona",20,1,19
"Gentianales","Rubiaceae","Coussarea",100,1,99
"Gentianales","Rubiaceae","Crocyllis",1,1,0
"Gentianales","Rubiaceae","Cuviera",14,14,0
"Gentianales","Rubiaceae"," Danaideae","Danais",31,0
"Gentianales","Rubiaceae","Diplospora",25,1,24
"Gentianales","Rubiaceae","Gaertnera",68,16,52
"Gentianales","Rubiaceae"," Rubieae","Galium",650,3
"Gentianales","Rubiaceae","Gouldia",3,3,0
"Gentianales","Rubiaceae","Coelospermum",11,11,0
"Gentianales","Rubiaceae","Gynochthodes",95,95,0
"Gentianales","Rubiaceae","Bobea",4,4,
"Gentianales","Rubiaceae","Guettarda",,,
"Gentianales","Rubiaceae","Timonius",200,200,0
"Gentianales","Rubiaceae","Hodgkinsonia",2,2,0
"Gentianales","Rubiaceae","Lasianthus",150,80,70
"Gentianales","Rubiaceae","Morindopsis",4,2,2
"Gentianales","Rubiaceae","Mussaenda",132,132,0
"Gentianales","Rubiaceae","Myonima",4,1,3
"Gentianales","Rubiaceae","Pacjystylus",2,1,1
"Gentianales","Rubiaceae"," Paederieae","Paederia",30,1
"Gentianales","Rubiaceae","Praravinia",50,1,49
"Gentianales","Rubiaceae","Prismatomeris",25,1,24
"Gentianales","Rubiaceae","Bullockia",8,,
"Gentianales","Rubiaceae","Canthium laeve",,1,
"Gentianales","Rubiaceae","Cyclophyllum",37,9,
"Gentianales","Rubiaceae","Peponidium",45,,
"Gentianales","Rubiaceae","Pyrostria",80,,
"Huerteales","Tapisciaceae","Tapiscia",3,3,0
"Lamiales","Lamiaceae","Basilicum",7,1,6
"Lamiales","Lamiaceae","Lepechinia",36,7,29
"Lamiales","Lamiaceae","Nepeta",250,10,240
"Lamiales","Lamiaceae","Tetradenia",6,6,0
"Lamiales","Oleaceae","Forestiera",15,15,0
"Lamiales","Oleaceae","Fraxinus",65,10,55
"Lamiales","Oleaceae","Olea",20,1,19
"Lamiales","Oleaceae","Osmanthus",15,1,14
"Lamiales","Oleaceae","Phillyrea",4,2,2
"Lamiales","Verbenaceae","Aegiphila",150,30,120
"Lamiales","Verbenaceae","Callicarpa",140,1,139
"Lamiales","Verbenaceae","Citharexylum",70,1,69
"Lamiales","Verbenaceae","Lippia",200,15,185
"Laurales","Hernandiaceae","Hazomalania",1,1,0
"Laurales","Lauraceae","Actinodaphne",100,100,0
"Laurales","Lauraceae","Litsea",400,400,0
"Laurales","Lauraceae","Neolitsea",100,100,0
"Laurales","Lauraceae","Sassafras",3,3,0
"Laurales","Lauraceae","Lindera",100,100,0
"Laurales","Lauraceae","Parasassafras",2,2,0
"Laurales","Lauraceae","Dodecadenia",1,1,0
"Laurales","Lauraceae","Laurus",2,2,0
"Laurales","Lauraceae","Iteadaphne",2,2,0
"Laurales","Lauraceae","Endlicheria",40,40,0
"Laurales","Lauraceae","Ocotea",350,3,347
"Laurales","Lauraceae","Rhodostemonodaphne",20,20,0
"Laurales","Lauraceae","Cinnadenia",2,2,0
"Laurales","Lauraceae","Hypodaphnis",1,1,0
"Laurales","Monimiaceae","Austromatthaea",1,1,0
"Laurales","Monimiaceae","Hedycarya",12,12,0
"Laurales","Monimiaceae","Hennecartia",1,1,0
"Laurales","Monimiaceae","Kibaropsis",1,1,0
"Laurales","Monimiaceae","Lauterbachia",1,1,0
"Laurales","Monimiaceae","Levieria",7,7,0
"Laurales","Monimiaceae","Macropeplus",1,1,0
"Laurales","Monimiaceae","Macrotorus",1,1,0
"Laurales","Monimiaceae","Mollinedia",20,20,0
"Laurales","Monimiaceae","Monimia",3,3,0
"Laurales","Monimiaceae","Palmeria",14,14,0
"Laurales","Monimiaceae","Peumus",1,1,0
"Laurales","Monimiaceae","Tambourissa",44,10,34
"Laurales","Monimiaceae","Xymalos",1,1,0
"Laurales","Siparunaceae","Glossocalyx",3,3,0
"Laurales","Siparunaceae","Siparuna",70,55,15
"Liliales","Liliaceae","Wurmbea",37,1,36
"Liliales","Melanthiaceae","Chamaelirium",1,1,0
"Liliales","Smilacaceae","Heterosmilax",15,5,10
"Liliales","Smilacaceae","Smilax",315,315,0
"Magnoliales","Annonaceae","Pseuduvaria",35,35,0
"Magnoliales","Annonaceae","Stelechocarpus",5,5,0
"Magnoliales","Annonaceae","Uvariopsis",12,6,6
"Magnoliales","Myristicaceae","Cephalosphae",1,1,0
"Magnoliales","Myristicaceae","Coelocaryon",4,4,0
"Magnoliales","Myristicaceae","Compsoneura",12,12,0
"Magnoliales","Myristicaceae","Gymnacranthera",7,7,0
"Magnoliales","Myristicaceae","Haematodendron",1,1,0
"Magnoliales","Myristicaceae","Horsfieldia",100,100,0
"Magnoliales","Myristicaceae","Iryanthera",24,24,0
"Magnoliales","Myristicaceae","Knema",83,83,0
"Magnoliales","Myristicaceae","Myristica",72,72,0
"Magnoliales","Myristicaceae","Osteophloeum",1,1,0
"Magnoliales","Myristicaceae","Otoba",6,6,0
"Magnoliales","Myristicaceae","Pycnanthus",7,5,2
"Magnoliales","Myristicaceae","Scyphocephalum",4,4,0
"Magnoliales","Myristicaceae","Virola",45,45,0
"malpighiales","Achariaceae","Buchnerodendron",2,2,0
"malpighiales","Achariaceae","Carpotroche",11,11,0
"malpighiales","Achariaceae","Gynocardia",1,1,0
"malpighiales","Achariaceae","Hydnocarpus",40,30,10
"malpighiales","Achariaceae","Kiggelaria",1,1,0
"malpighiales","Achariaceae","Pangium",1,1,0
"malpighiales","Achariaceae","Ryparosa",18,18,0
"malpighiales","Achariaceae","Trichadenia",2,2,0
"malpighiales","Balanopaceae","Balanops",9,9,0
"malpighiales","Centroplacaceae","Centroplacus",1,1,0
"malpighiales","Clusiaceae","Allanblackia",10,1,9
"malpighiales","Clusiaceae","Clusia",250,240,10
"malpighiales","Clusiaceae","Clusiella",1,1,0
"malpighiales","Clusiaceae","Garcinia",250,250,0
"malpighiales","Clusiaceae","Haploclathra",3,3,0
"malpighiales","Clusiaceae","Havetia",1,1,0
"malpighiales","Clusiaceae","Havetiopsis",5,5,0
"malpighiales","Clusiaceae","Kielmeyera",20,5,15
"malpighiales","Clusiaceae","Marila",20,10,10
"malpighiales","Clusiaceae","Oedematopus",10,10,0
"malpighiales","Clusiaceae","Pilosperma",2,2,0
"malpighiales","Clusiaceae","Quapoya",5,5,0
"malpighiales","Clusiaceae","Renggeria",3,2,1
"malpighiales","Clusiaceae","Tovomita",20,20,0
"malpighiales","Clusiaceae","Tovomitopsis",50,40,10
"malpighiales","Dichapetalaceae","Dichapetalum",124,20,104
"malpighiales","Euphorbiaceae","Acalypha",430,220,210
"malpighiales","Euphorbiaceae","Adelia",5,5,0
"malpighiales","Euphorbiaceae","Adenocline",8,3,5
"malpighiales","Euphorbiaceae","Adenophaedra",3,2,1
"malpighiales","Euphorbiaceae","Adriana",5,5,0
"malpighiales","Euphorbiaceae","Agrostistachys",8,7,1
"malpighiales","Euphorbiaceae","Alchornea",50,40,10
"malpighiales","Euphorbiaceae","Alchorneopsis",3,3,0
"malpighiales","Euphorbiaceae","Amperea",8,4,4
"malpighiales","Euphorbiaceae","Anomalocalyx",1,1,0
"malpighiales","Euphorbiaceae","Aparisthmium",1,1,0
"malpighiales","Euphorbiaceae","Baliospermum",12,4,8
"malpighiales","Euphorbiaceae","Baloghia",13,9,4
"malpighiales","Euphorbiaceae","Benoistia",3,3,0
"malpighiales","Euphorbiaceae","Bernardia",50,10,40
"malpighiales","Euphorbiaceae","Beyeria",15,1,14
"malpighiales","Euphorbiaceae","Blumeodendron",6,6,0
"malpighiales","Euphorbiaceae","Bocquillonia",14,5,9
"malpighiales","Euphorbiaceae","Caperonia",40,5,35
"malpighiales","Euphorbiaceae","Caryodendron",3,3,0
"malpighiales","Euphorbiaceae","Cavacoa",3,3,0
"malpighiales","Euphorbiaceae","Cheilosa",2,2,0
"malpighiales","Euphorbiaceae","Chlamydojatropha",1,1,0
"malpighiales","Euphorbiaceae","Chondrostylis",1,1,0
"malpighiales","Euphorbiaceae","Claoxylon",80,80,0
"malpighiales","Euphorbiaceae","Cleidion",25,20,5
"malpighiales","Euphorbiaceae","Cocconerion",2,2,0
"malpighiales","Euphorbiaceae","Codiaeum",15,15,0
"malpighiales","Euphorbiaceae","Conceveiba",7,7,0
"malpighiales","Euphorbiaceae","Croton",800,100,700
"malpighiales","Euphorbiaceae","Crotonogyne",1,1,0
"malpighiales","Euphorbiaceae","Deuteromallotus",2,2,0
"malpighiales","Euphorbiaceae","Dimorphocalyx",15,10,5
"malpighiales","Euphorbiaceae","Discocleidion",2,1,1
"malpighiales","Euphorbiaceae","Discoglypremna",1,1,0
"malpighiales","Euphorbiaceae","Ditta",1,1,0
"malpighiales","Euphorbiaceae","Endospermum",10,10,0
"malpighiales","Euphorbiaceae","Erythrococca",50,50,0
"malpighiales","Euphorbiaceae","Euphorbia",1000,100,900
"malpighiales","Euphorbiaceae","Excoecaria",30,3,27
"malpighiales","Euphorbiaceae","Fontainea",6,2,4
"malpighiales","Euphorbiaceae","Givotia",4,4,0
"malpighiales","Euphorbiaceae","Grossera",7,7,0
"malpighiales","Euphorbiaceae","Gymnanthes",40,1,39
"malpighiales","Euphorbiaceae","Hamilcoa",1,1,0
"malpighiales","Euphorbiaceae","Homonoia",2,2,0
"malpighiales","Euphorbiaceae","Hyaenanche",1,1,0
"malpighiales","Euphorbiaceae","Jatropha",170,70,100
"malpighiales","Euphorbiaceae","Klaineanthus",1,1,0
"malpighiales","Euphorbiaceae","Lasiocroton",5,5,0
"malpighiales","Euphorbiaceae","Lautembergia",4,4,0
"malpighiales","Euphorbiaceae","Leucocroton",20,15,5
"malpighiales","Euphorbiaceae","Macaranga",300,300,0
"malpighiales","Euphorbiaceae","Mallotus",150,150,0
"malpighiales","Euphorbiaceae","Manniophyton",1,1,0
"malpighiales","Euphorbiaceae","Maprounea",4,1,3
"malpighiales","Euphorbiaceae","Martretia",2,2,0
"malpighiales","Euphorbiaceae","Mercurialis",8,7,1
"malpighiales","Euphorbiaceae","Micrandra",17,1,16
"malpighiales","Euphorbiaceae","Micrococca",12,6,6
"malpighiales","Euphorbiaceae","Mildbraedia",4,2,2
"malpighiales","Euphorbiaceae","Neoboutonia",3,3,0
"malpighiales","Euphorbiaceae","Neoscortechinia",4,4,0
"malpighiales","Euphorbiaceae","Neotrewia",1,1,0
"malpighiales","Euphorbiaceae","Omalanthus",35,1,34
"malpighiales","Euphorbiaceae","Omphalea",20,0,20
"malpighiales","Euphorbiaceae","Ostodes",4,1,3
"malpighiales","Euphorbiaceae","Pausandra",8,8,0
"malpighiales","Euphorbiaceae","Philyra",1,1,0
"malpighiales","Euphorbiaceae","Pimeleodendron",6,6,0
"malpighiales","Euphorbiaceae","Plagiostyles",1,1,0
"malpighiales","Euphorbiaceae","Pseudagrostistachys",2,2,0
"malpighiales","Euphorbiaceae","Ptychopyxis",13,13,0
"malpighiales","Euphorbiaceae","Ricinodendron",2,2,0
"malpighiales","Euphorbiaceae","Sandwithia",2,2,0
"malpighiales","Euphorbiaceae","Sapium",100,1,99
"malpighiales","Euphorbiaceae","Spathiostemon",2,2,0
"malpighiales","Euphorbiaceae","Suregada",40,40,0
"malpighiales","Euphorbiaceae","Tannodia",3,3,0
"malpighiales","Euphorbiaceae","Tapoides",1,1,0
"malpighiales","Euphorbiaceae","Tetrorchidium",20,20,0
"malpighiales","Euphorbiaceae","Tragia",125,1,124
"malpighiales","Euphorbiaceae","Trewia",1,1,0
"malpighiales","Euphorbiaceae","Wetria",1,1,0
"malpighiales","Peraceae","Chaetocarpus",12,12,0
"malpighiales","Peraceae","Clutia",75,75,0
"malpighiales","Peraceae","Pera",30,30,0
"malpighiales","Peraceae","Pogonophora",2,2,0
"malpighiales","Peraceae","Trigonopleura",1,1,0
"Malpighiales","Rafflesiaceae","Apodanthes",1,1,0
"Malpighiales","Rafflesiaceae","Bdallophyton",2,1,1
"Malpighiales","Rafflesiaceae","Berlinianche",2,2,0
"Malpighiales","Rafflesiaceae","Cytinus",6,3,3
"Malpighiales","Rafflesiaceae","Pilostyles",12,12,0
"Malpighiales","Rafflesiaceae","Rafflesia",15,15,0
"Malpighiales","Rafflesiaceae","Rhizanthes",2,2,0
"Malpighiales","Rafflesiaceae","Sapria",1,1,0
"malpighiales","Lacistemataceae","Lozania",3,1,2
"malpighiales","Malpighiaceae","Microsteira",25,1,24
"malpighiales","Malpighiaceae","Ryssopterys",6,0,6
"malpighiales","Malpighiaceae","Spachea",6,3,3
"Malpighiales","Ochnaceae","Schuurmansia",3,0,3
"malpighiales","Pandaceae","Galearia",6,6,0
"malpighiales","Pandaceae","Microdesmis",10,10,0
"malpighiales","Pandaceae","Panda",1,1,0
"malpighiales","Passifloraceae","Adenia",93,30,63
"malpighiales","Passifloraceae","Passiflora",350,1,349
"malpighiales","Phyllanthaceae","Antidesma",150,150,0
"malpighiales","Phyllanthaceae","Aporusa",75,30,45
"malpighiales","Phyllanthaceae","Astrocasia",5,5,0
"malpighiales","Phyllanthaceae","Baccaurea",80,40,40
"malpighiales","Phyllanthaceae","Bischofia",1,1,0
"malpighiales","Phyllanthaceae","Bridelia",60,3,57
"malpighiales","Phyllanthaceae","Chonocentrum",1,1,0
"malpighiales","Phyllanthaceae","Cleistanthus",140,20,120
"malpighiales","Phyllanthaceae","Discocarpus",5,5,0
"malpighiales","Phyllanthaceae","Flueggea",14,14,0
"malpighiales","Phyllanthaceae","Heywoodia",1,1,0
"malpighiales","Phyllanthaceae","Hyeronima",20,20,0
"malpighiales","Phyllanthaceae","Hymenocardia",6,6,0
"malpighiales","Phyllanthaceae","Lachnostylis",1,1,0
"malpighiales","Phyllanthaceae","Leptonema",2,2,0
"malpighiales","Phyllanthaceae","Leptopus",10,10,0
"malpighiales","Phyllanthaceae","Maesobotrya",20,20,0
"malpighiales","Phyllanthaceae","Margaritaria",14,14,0
"malpighiales","Phyllanthaceae","Oreoporanthera",1,1,0
"malpighiales","Phyllanthaceae","Phyllanthus",750,100,650
"malpighiales","Phyllanthaceae","Protomegabaria",2,2,0
"malpighiales","Phyllanthaceae","Pseudolachnostylis",1,1,0
"malpighiales","Phyllanthaceae","Reverchonia",1,1,0
"malpighiales","Phyllanthaceae","Richeria",2,2,0
"malpighiales","Phyllanthaceae","Richeriella",2,2,0
"malpighiales","Phyllanthaceae","Savia",25,10,15
"malpighiales","Phyllanthaceae","Securingea",5,5,0
"malpighiales","Phyllanthaceae","Spondianthus",1,1,0
"malpighiales","Phyllanthaceae","Thecacoris",20,20,0
"malpighiales","Phyllanthaceae","Uapaca",61,61,0
"malpighiales","Picrodendraceae","Androstachys",5,1,4
"malpighiales","Picrodendraceae","Austrobuxus",17,17,0
"malpighiales","Picrodendraceae","Mischodon",1,1,0
"malpighiales","Picrodendraceae","Oldfieldia",4,4,0
"malpighiales","Picrodendraceae","Picrodendron",1,1,0
"malpighiales","Picrodendraceae","Piranhea",2,2,0
"malpighiales","Picrodendraceae","Tetracoccus",4,4,0
"malpighiales","Putranjivaceae","Drypetes",200,200,0
"malpighiales","Putranjivaceae","Sibangea",3,3,0
"malpighiales","Rhizophoraceae","Paradrypetes",2,2,0
"malpighiales","Rhizophoraceae","Blepharistemma",1,0,1
"malpighiales","Rhizophoraceae","Sterigmapetalum",7,7,0
"malpighiales","Salicaceae","Bartholomaea",2,2,0
"malpighiales","Salicaceae","Bennettiodendron",2,2,0
"malpighiales","Salicaceae","Dovyalis",15,15,0
"malpighiales","Salicaceae","Hasseltiopsis",1,1,0
"malpighiales","Salicaceae","Idesia",1,1,0
"malpighiales","Salicaceae","Itoa",2,2,0
"malpighiales","Salicaceae","Mayna",6,6,0
"malpighiales","Salicaceae","Neoptychocarpus",2,2,0
"malpighiales","Salicaceae","Olmediella",1,1,0
"malpighiales","Salicaceae","Oncoba",4,1,3
"malpighiales","Salicaceae","Poliothyrsis",1,1,0
"malpighiales","Salicaceae","Populus",35,35,0
"malpighiales","Salicaceae","Priamosia",1,1,0
"malpighiales","Salicaceae","Salix",401,400,1
"malpighiales","Salicaceae","Sclerocarya",4,2,2
"malpighiales","Salicaceae","Trichostephanus",1,1,0
"malpighiales","Salicaceae","Trimeria",2,2,0
"malpighiales","Salicaceae","Xylosma",85,85,0
"malpighiales","Scyphostegiaceae","Scyphostegia",1,1,0
"malpighiales","Turneraceae","Hyalocalyx",1,1,0
"malpighiales","Turneraceae","Mathurina",1,1,0
"malpighiales","Turneraceae","Piriqueta",41,10,31
"malpighiales","Turneraceae","Streptopetalum",6,1,5
"malpighiales","Turneraceae","Turnera",120,10,110
"malpighiales","Violaceae","Melicytus",4,4,0
"Malvales","Malvaceae"," Byttnerioideae","Byttneria",131,1
"Malvales","Malvaceae"," Malvoideae","Hampea",13,10
"Malvales","Malvaceae"," Grewioideae","Heliocarpus",22,22
"Malvales","Malvaceae"," Malvoideae","Napaea",1,1
"Malvales","Malvaceae"," Malvoideae","Plagianthus",15,14
"Malvales","Thymelaeaceae","Goodallia",1,1,0
"Malvales","Thymelaeaceae","Ovidia",4,2,2
"Malvales","Thymelaeaceae","Solmsia",2,2,0
"Malvales","Thymelaeaceae","Funifera",3,3,0
"Malvales","Thymelaeaceae","Thymelaea",30,1,29
"Malvales","Thymelaeaceae","Wikstroemia",70,70,0
"Malvales","Thymelaeaceae","Daphnopsis",73,73,0
"Malvales","Thymelaeaceae","Schoenobiblus",,,
"myrtales","Memecylaceae","Lijndenia",10,10,0
"myrtales","Myrtaceae","Decaspermum",30,1,29
"myrtales","Myrtaceae","Eugenia",1000,10,990
"myrtales","Myrtaceae","Pimenta",2,1,1
"myrtales","Onagraceae","Fuchsia",100,4,96
"oxalidales","Cunoniaceae","Brunellia",52,10,42
"oxalidales","Cunoniaceae","Caldcluvia",11,1,10
"oxalidales","Cunoniaceae","Pancheria",26,11,15
"oxalidales","Cunoniaceae","Vessellowskya",1,1,0
"oxalidales","Elaeocarpaceae","Aristotelia",5,1,4
"oxalidales","Elaeocarpaceae","Elaeocarpus",360,1,359
"Pandanales","Pandanaceae","Freycinetia",175,175,0
"Pandanales","Pandanaceae","Pandanus",600,600,0
"Pandanales","Pandanaceae","Sararanga",2,2,0
"Pandanales","Triuridaceae","Peltophyllum",2,2,0
"Pandanales","Triuridaceae","Triuris",3,3,0
"Piperales","Piperaceae","Macropiper",9,8,1
"Piperales","Piperaceae","Piper",1000,300,700
"Poales","Cyperaceae","Carex",1000,21,979
"Poales","Cyperaceae","Didymiandrum",3,1,2
"Poales","Cyperaceae","Kobresia",35,30,5
"Poales","Cyperaceae","Scirpus",200,1,199
"Poales","Eriocaulaceae","Eriocaulon",400,2,398
"Poales","Juncaceae","Distichia",2,2,0
"Poales","Juncaceae","Oxychloe",7,7,0
"Poales","Juncaceae","Patosia",2,2,0
"Poales","Poaceae","Aciachne",1,1,0
"Poales","Poaceae","Calamagrostis",270,1,269
"Poales","Poaceae","Digitaria",300,3,297
"Poales","Poaceae"," Monanthochloinae","Distichlis",13,13
"Poales","Poaceae"," Monanthochloinae","Jouvea",2,2
"Poales","Poaceae"," Monanthochloinae","Reederochloa",1,1
"Poales","Poaceae"," Monanthochloinae","Monanthochloe",2,2
"Poales","Poaceae"," Monanthochloinae","Scleropogon",1,1
"Poales","Poaceae"," Eragrostidae","Sohnsia",1,1
"Poales","Poaceae"," Eragrostidae","Neeragrostis",1,1
"Poales","Poaceae"," Monanthochloinae","Allolepis",1,1
"Poales","Poaceae"," Boutelouinae","Buchloe",1,1
"Poales","Poaceae"," Boutelouinae","Buchlomimus",1,1
"Poales","Poaceae"," Boutelouinae","Cyclostachya",1,1
"Poales","Poaceae"," Boutelouinae","Soderstromia",1,1
"Poales","Poaceae"," Boutelouinae","Opizia",1,1
"Poales","Poaceae","Festuca",450,10,440
"Poales","Poaceae","Gynerium",1,1,0
"Poales","Poaceae","Hesperochloa",1,1,0
"Poales","Poaceae","Poa",250,10,240
"Poales","Poaceae","Pseudochaetochloa",1,1,0
"Poales","Poaceae","Spinifex",4,4,0
"Poales","Poaceae","Zygochloa",1,1,0
"Poales","Restionaceae","Anarthria",6,6,0
"Poales","Restionaceae","Anthochortus",6,6,0
"Poales","Restionaceae","Askidiosperma",10,10,0
"Poales","Restionaceae","Calopsis",23,23,0
"Poales","Restionaceae","Cannomois",6,6,0
"Poales","Restionaceae","Ceratocaryum",5,5,0
"Poales","Restionaceae","Chaetanthus",1,1,0
"Poales","Restionaceae","Chondropetalum",12,12,0
"Poales","Restionaceae","Dielsia",1,1,0
"Poales","Restionaceae","Dovea",6,6,0
"Poales","Restionaceae","Elegia",32,32,0
"Poales","Restionaceae","Harperia",1,1,0
"Poales","Restionaceae","Hopkinsia",2,2,0
"Poales","Restionaceae","Hydrophilos",1,1,0
"Poales","Restionaceae","Hypodiscus",16,16,0
"Poales","Restionaceae","Hypolaena",4,4,0
"Poales","Restionaceae","Ischyrolepis",46,46,0
"Poales","Restionaceae","Lepidobolus",5,3,2
"Poales","Restionaceae","Leptocarpus",16,10,6
"Poales","Restionaceae","Lepyrodia",17,5,12
"Poales","Restionaceae","Loxocarya",8,5,3
"Poales","Restionaceae","Lyginia",1,1,0
"Poales","Restionaceae","Mastersiella",3,3,0
"Poales","Restionaceae","Nevillea",2,2,0
"Poales","Restionaceae","Onychosepalum",2,2,0
"Poales","Restionaceae","Platycaulos",8,8,0
"Poales","Restionaceae","Restio",88,88,0
"Poales","Restionaceae","Rhodocoma",3,3,0
"Poales","Restionaceae","Staberoha",9,9,0
"Poales","Restionaceae","Thamnochortus",37,37,0
"Poales","Restionaceae","Willdenowia",10,10,0
"Proteales","Proteaceae","Aulax",3,3,0
"Proteales","Proteaceae","Leucadendron",81,81,0
"ranunculales","Lardizabalaceae","Boquila",1,1,0
"ranunculales","Lardizabalaceae","Lardizabala",1,1,0
"ranunculales","Lardizabalaceae","Sargentodoxa",1,1,0
"ranunculales","Menispermaceae","All",500,500,0
"ranunculales","Menispermaceae","Abuta",32,32,0
"ranunculales","Menispermaceae","Albertisia",18,18,0
"ranunculales","Menispermaceae","Anamirta",1,1,0
"ranunculales","Menispermaceae","Anisocycla",5,5,0
"ranunculales","Menispermaceae","Anomospermum",8,8,0
"ranunculales","Menispermaceae","Antizoma",5,5,0
"ranunculales","Menispermaceae","Arcangelisia",4,4,0
"ranunculales","Menispermaceae","Aspidocarya",1,1,0
"ranunculales","Menispermaceae","Beirnaertia",2,2,0
"ranunculales","Menispermaceae","Borismene",1,1,0
"ranunculales","Menispermaceae","Burasaia",4,4,0
"ranunculales","Menispermaceae","Calycocarpum",1,1,0
"ranunculales","Menispermaceae","Carronia",4,4,0
"ranunculales","Menispermaceae","Caryomene",5,5,0
"ranunculales","Menispermaceae","Chasmanthera",2,2,0
"ranunculales","Menispermaceae","Chlaenandra",1,1,0
"ranunculales","Menispermaceae","Chondrodendron",8,8,0
"ranunculales","Menispermaceae","Cissampelos",23,23,0
"ranunculales","Menispermaceae","Cocculus",15,15,0
"ranunculales","Menispermaceae","Coscinium",2,2,0
"ranunculales","Menispermaceae","Curarea",4,4,0
"ranunculales","Menispermaceae","Cyclea",27,27,0
"ranunculales","Menispermaceae","Dialytheca",1,1,0
"ranunculales","Menispermaceae","Dioscoreophyllum",6,6,0
"ranunculales","Menispermaceae","Diploclisia",3,3,0
"ranunculales","Menispermaceae","Disciphania",26,26,0
"ranunculales","Menispermaceae","Elephantomene",1,1,0
"ranunculales","Menispermaceae","Eleutharrhene",1,1,0
"ranunculales","Menispermaceae","Fibraurea",5,5,0
"ranunculales","Menispermaceae","Haematocarpus",2,2,0
"ranunculales","Menispermaceae","Hyperbaena",25,25,0
"ranunculales","Menispermaceae","Hypserpa",11,11,0
"ranunculales","Menispermaceae","Jateorhiza",2,2,0
"ranunculales","Menispermaceae","Kolobopetalum",4,4,0
"ranunculales","Menispermaceae","Legnephora",5,5,0
"ranunculales","Menispermaceae","Leptoterantha",1,1,0
"ranunculales","Menispermaceae","Limacia",3,3,0
"ranunculales","Menispermaceae","Limaciopsis",2,2,0
"ranunculales","Menispermaceae","Macrococculus",1,1,0
"ranunculales","Menispermaceae","Menispermum",6,6,0
"ranunculales","Menispermaceae","Odontocarya",40,40,0
"ranunculales","Menispermaceae","Orthogynium",1,1,0
"ranunculales","Menispermaceae","Orthomene",4,4,0
"ranunculales","Menispermaceae","Pachygone",12,12,0
"ranunculales","Menispermaceae","Parabaena",12,12,0
"ranunculales","Menispermaceae","Penianthus",4,4,0
"ranunculales","Menispermaceae","Pericampylus",4,4,0
"ranunculales","Menispermaceae","Platytinospora",1,1,0
"ranunculales","Menispermaceae","Pleogyne",1,1,0
"ranunculales","Menispermaceae","Pycnarrhena",11,11,0
"ranunculales","Menispermaceae","Rhaptonema",7,7,0
"ranunculales","Menispermaceae","Rhigiocarya",2,2,0
"ranunculales","Menispermaceae","Sarcolophium",1,1,0
"ranunculales","Menispermaceae","Sarcopetalum",1,1,0
"ranunculales","Menispermaceae","Sciadotenia",20,20,0
"ranunculales","Menispermaceae","Sinomenium",1,1,0
"ranunculales","Menispermaceae","Sphenocentrum",1,1,0
"ranunculales","Menispermaceae","Spirospermum",1,1,0
"ranunculales","Menispermaceae","Stephania",70,70,0
"ranunculales","Menispermaceae","Strychnopsis",1,1,0
"ranunculales","Menispermaceae","Synandropus",1,1,0
"ranunculales","Menispermaceae","Synclisia",1,1,0
"ranunculales","Menispermaceae","Syntriandrium",1,1,0
"ranunculales","Menispermaceae","Syrrheonema",3,3,0
"ranunculales","Menispermaceae","Telitoxicum",8,8,0
"ranunculales","Menispermaceae","Tiliacora",22,22,0
"ranunculales","Menispermaceae","Tinomiscium",8,8,0
"ranunculales","Menispermaceae","Tinospora",43,43,0
"ranunculales","Menispermaceae","Triclisia",16,16,0
"ranunculales","Menispermaceae","Ungulipetalum",1,1,0
"ranunculales","Ranunculaceae","Clematis",295,5,290
"ranunculales","Ranunculaceae","Hamadryas",6,6,0
"ranunculales","Ranunculaceae","Paroxygraphis",1,1,0
"ranunculales","Ranunculaceae","Thalictrum",160,9,151
"Rosales","Barbeyaceae","Barbeya",1,1,0
"Rosales","Cannabaceae","Cannabis",1,1,0
"Rosales","Cannabaceae","Humulus",3,3,0
"Rosales","Elaeagnaceae","Hippophae",3,3,0
"Rosales","Elaeagnaceae","Shepherdia",3,3,0
"Rosales","Moraceae","Antiaropsis",1,1,0
"Rosales","Moraceae","Bagassa",1,1,0
"Rosales","Moraceae","Batocarpus",4,4,0
"Rosales","Moraceae","Brosimum",13,6,7
"Rosales","Moraceae","Broussonetia",8,8,0
"Rosales","Moraceae","Castilla",3,1,2
"Rosales","Moraceae","Clarisia",3,3,0
"Rosales","Moraceae","Ficus",750,100,650
"Rosales","Moraceae","Helianthostylis",2,2,0
"Rosales","Moraceae","Helicostylis",7,3,4
"Rosales","Moraceae","Maclura",11,11,0
"Rosales","Moraceae","Maquira",5,4,1
"Rosales","Moraceae","Milicia",2,2,0
"Rosales","Moraceae","Morus",10,5,5
"Rosales","Moraceae","Naucleopsis",25,20,5
"Rosales","Moraceae","Olmedia",1,1,0
"Rosales","Moraceae","Parartocarpus",3,2,1
"Rosales","Moraceae","Perebea",9,4,5
"Rosales","Moraceae","Pseudolmedia",9,9,0
"Rosales","Moraceae","Sorocea",20,20,0
"Rosales","Moraceae","Sparattosyce",1,1,0
"Rosales","Moraceae","Streblus",25,15,10
"Rosales","Moraceae","Treculia",3,3,0
"Rosales","Moraceae","Trophis",9,9,0
"Rosales","Rhamnaceae","Discaria",15,1,14
"Rosales","Rhamnaceae","Rhamnus",125,70,55
"Rosales","Rosaceae","Aruncus",1,1,0
"Rosales","Rosaceae","Bencomia",8,6,2
"Rosales","Rosaceae","Cliffortia",115,40,75
"Rosales","Rosaceae","Fragaria",12,1,11
"Rosales","Rosaceae","Hagenia",1,1,0
"Rosales","Rosaceae","Kageneckia",3,3,0
"Rosales","Rosaceae","Maddenia",4,4,0
"Rosales","Rosaceae","Oemleria",1,1,0
"Rosales","Rosaceae","Potentilla",500,1,499
"Rosales","Rosaceae","Prunus",400,1,399
"Rosales","Rosaceae","Rubus",250,5,245
"Rosales","Urticaceae","Boehmeria",80,40,40
"Rosales","Urticaceae","Cecropia",75,75,0
"Rosales","Urticaceae","Coussapoa",50,50,0
"Rosales","Urticaceae","Chamabainia",2,1,1
"Rosales","Urticaceae","Cypholophus",15,7,8
"Rosales","Urticaceae","Debregeasia",4,2,2
"Rosales","Urticaceae","Dendrocnide",37,37,0
"Rosales","Urticaceae","Elatostema",300,150,150
"Rosales","Urticaceae","Girardinia",2,1,1
"Rosales","Urticaceae","Gyrotaenia",4,4,0
"Rosales","Urticaceae","Laportea",21,10,11
"Rosales","Urticaceae","Lecanthus",1,1,0
"Rosales","Urticaceae","Leucosyke",35,30,5
"Rosales","Urticaceae","Maoutia",15,10,5
"Rosales","Urticaceae","Meniscogyne",2,1,1
"Rosales","Urticaceae","Musanga",2,2,0
"Rosales","Urticaceae","Myrianthus",7,7,0
"Rosales","Urticaceae","Myriocarpa",18,15,3
"Rosales","Urticaceae","Neraudia",5,5,0
"Rosales","Urticaceae","Phenax",12,2,10
"Rosales","Urticaceae","Pilea",250,100,150
"Rosales","Urticaceae","Pipturus",30,15,15
"Rosales","Urticaceae","Poikilospermum",20,10,10
"Rosales","Urticaceae","Pourouma",30,30,0
"Rosales","Urticaceae","Pouzolzia",70,10,60
"Rosales","Urticaceae","Procris",20,10,10
"Rosales","Urticaceae","Sarcochlamys",1,1,0
"Rosales","Urticaceae","Sarcopilea",1,1,0
"Rosales","Urticaceae","Touchardia",1,1,0
"Rosales","Urticaceae","Urera",35,18,17
"Rosales","Urticaceae","Urtica",80,40,40
"Balanophorales","Balanophoraceae","Balanophora",16,16,0
"Balanophorales","Balanophoraceae","Dactylanthus",1,1,0
"Balanophorales","Balanophoraceae","Hachettea",1,1,0
"Balanophorales","Balanophoraceae","Langsdorffia",3,1,2
"Balanophorales","Balanophoraceae","Rhopalocnemis",1,1,0
"Balanophorales","Balanophoraceae","Sarcophyte",2,2,0
"Balanophorales","Balanophoraceae","Thonningia",1,1,0
"santalales","Loranthaceae","Barathranthus",2,1,1
"santalales","Loranthaceae","Cladocolea",23,10,13
"santalales","Loranthaceae","Ileostylus",1,1,0
"santalales","Loranthaceae","Oryctanthus",10,1,9
"santalales","Loranthaceae","Phthirusa",60,50,10
"santalales","Loranthaceae","Struthanthus",50,50,0
"santalales","Loranthaceae","Tupeia",1,1,0
"santalales","Misodendraceae","Misodendrum",8,8,0
"santalales","Olacaceae","Aptandra",4,1,3
"santalales","Octoknemaceae","Octoknema",14,14,0
"santalales","Opiliaceae","Agonandra",10,10,0
"santalales","Opiliaceae","Gjellerupia",1,1,0
"santalales","Opiliaceae","Anthobolus",3,3,0
"santalales","Santalaceae","Antidaphne",9,6,3
"santalales","Santalaceae","Arceuthobium",31,9,22
"santalales","Santalaceae","Buckleya",4,4,0
"santalales","Santalaceae","Thesidium",8,8,0
"santalales","Santalaceae","Colpoon",1,1,0
"santalales","Santalaceae","Osyris",6,4,2
"santalales","Santalaceae","Dendrophthora",53,20,33
"santalales","Santalaceae","Dendrotrophe",4,2,2
"santalales","Santalaceae","Exocarpos",26,14,12
"santalales","Santalaceae","Lepidoceras",2,2,0
"santalales","Santalaceae","Nanodea",1,1,0
"santalales","Santalaceae","Omphacomeria",1,1,0
"santalales","Santalaceae","Phoradendron",190,50,140
"santalales","Santalaceae","Scleropyrum",6,1,5
"santalales","Santalaceae","Viscum",100,10,90
"sapindales","Anacardiaceae","Amphipterygium",4,1,3
"sapindales","Anacardiaceae","Astronium",10,10,0
"sapindales","Anacardiaceae","Blepharocarya",2,1,1
"sapindales","Anacardiaceae","Campnosperma",10,5,5
"sapindales","Anacardiaceae","Faguetia",1,1,0
"sapindales","Anacardiaceae","Haematostaphis",2,2,0
"sapindales","Anacardiaceae","Haplorhus",1,1,0
"sapindales","Anacardiaceae","Harpephyllum",1,1,0
"sapindales","Anacardiaceae","Heeria",1,1,0
"sapindales","Anacardiaceae","Lannea",40,14,26
"sapindales","Anacardiaceae","Laurophyllus",1,1,0
"sapindales","Anacardiaceae","Lithrea",3,3,0
"sapindales","Anacardiaceae","Loxopterygium",5,5,0
"sapindales","Anacardiaceae","Loxostylis",1,1,0
"sapindales","Anacardiaceae","Mosquitoxylum",1,1,0
"sapindales","Anacardiaceae","Orthopterygium",1,1,0
"sapindales","Anacardiaceae","Ozoroa",40,40,0
"sapindales","Anacardiaceae","Parishia",5,4,1
"sapindales","Anacardiaceae","Pegia",3,1,2
"sapindales","Anacardiaceae","Pistacia",9,5,4
"sapindales","Anacardiaceae","Pleiogynium",2,1,1
"sapindales","Anacardiaceae","Poupartia",12,4,8
"sapindales","Anacardiaceae","Protorhus",21,15,6
"sapindales","Anacardiaceae","Pseudosmodinglum",7,3,4
"sapindales","Anacardiaceae","Pseudospondias",2,1,1
"sapindales","Anacardiaceae","Rhodosphaera",1,1,0
"sapindales","Anacardiaceae","Rhus",200,180,20
"sapindales","Anacardiaceae","Schinus",27,20,7
"sapindales","Anacardiaceae","Semecarpus",60,50,10
"sapindales","Anacardiaceae","Smodingium",1,1,0
"sapindales","Anacardiaceae","Sorindeia",50,25,25
"sapindales","Anacardiaceae","Spondias",10,1,9
"sapindales","Anacardiaceae","Tapirira",15,15,0
"sapindales","Anacardiaceae","Trichoscypha",50,25,25
"sapindales","Burseraceae","Bursera",50,40,10
"sapindales","Burseraceae","Canarium",75,75,0
"sapindales","Burseraceae","Crepidospermum",5,1,4
"sapindales","Burseraceae","Protium",85,40,45
"sapindales","Burseraceae","Tetragastris",8,8,0
"sapindales","Burseraceae","Trattinnickia",11,11,0
"sapindales","Meliaceae","Aphanamixis",4,4,0
"sapindales","Meliaceae","Chisocheton",51,1,50
"sapindales","Meliaceae","Guarea",35,35,0
"sapindales","Meliaceae","Ruagea",5,5,0
"sapindales","Meliaceae","Trichilia",86,60,26
"sapindales","Rutaceae","Amyris",30,10,20
"sapindales","Rutaceae","Araliopsis",3,1,2
"sapindales","Rutaceae","Lunasia",10,4,6
"sapindales","Rutaceae","Orixa",1,1,0
"sapindales","Rutaceae","Phellodendron",10,10,0
"sapindales","Rutaceae","Ptaeroxylon",1,1,0
"sapindales","Rutaceae","Ptelea",3,3,0
"sapindales","Rutaceae","Skimmia",5,5,0
"sapindales","Rutaceae","Teclea",22,22,0
"sapindales","Rutaceae","Zanthoxylum",200,10,190
"sapindales","Sapindaceae","Acer",110,19,91
"sapindales","Sapindaceae","Dipteronia",2,1,1
"sapindales","Sapindaceae","Distichostemon",6,1,5
"sapindales","Sapindaceae","Dodonaea",50,20,30
"sapindales","Sapindaceae","Nephelium",35,1,34
"sapindales","Sapindaceae","Pappea",1,1,0
"sapindales","Sapindaceae","Xerospermum",2,2,0
"sapindales","Simaroubaceae","Ailanthus",5,2,3
"sapindales","Simaroubaceae","Castela",15,3,12
"sapindales","Simaroubaceae","Leitneria",1,1,0
"sapindales","Simaroubaceae","Picrolemma",3,1,2
"sapindales","Simaroubaceae","Simarouba",35,6,29
"saxifragales","Crassulaceae","Rhodiola",61,30,31
"saxifragales","Crassulaceae","Sedum",600,10,590
"saxifragales","Daphniphyllaceae","Daphniphyllum",10,10,0
"Saxifragales","Cercidiphyllaceae","Cercidiphyllum",2,2,0
"saxifragales","Grossulariaceae","Ribes",150,61,89
"saxifragales","Haloragaceae","Myriophyllum",40,1,39
"saxifragales","Saxifragaceae","Tanakaea",1,1,0
"solanales","Montiniaceae","Grevea",3,3,0
"solanales","Montiniaceae","Kaliphora",1,1,0
"solanales","Montiniaceae","Montinia",1,1,0
"solanales","Solanaceae","Deprea",6,1,5
"solanales","Solanaceae","Dunalia",6,1,5
"solanales","Solanaceae","Lycium",75,6,69
"solanales","Solanaceae","Solanum",1000,11,989
"solanales","Solanaceae","Symonanthus",2,2,0
"solanales","Solanaceae","Withania",10,1,9
"Amborellales","Amborellaceae","Amborella",1,1,0
"Poales","Bromeliaceae","Hechtia",45,45,0
"Chloranthales","Chloranthaceae","Ascarina",12,10,2
"Chloranthales","Chloranthaceae","Heyosmum",45,41,4
"Gunnerales","Gunneraceae","Gunnera",40,10,30
"Austrobaileyales","Illiciaceae","Kadsura",24,10,14
"Austrobaileyales","Illiciaceae","Schisandra",25,10,15
"Canellales","Winteraceae","Drimys",11,5,6
"Zygophyllales","Zygophyllaceae","Neoluederitzla",1,1,0
